####################
#               #  #
#          #  ###  #
#          ###     #
#  PPP             #
#   P              #
#   P              #
#   PPPPPPPPP   S  #
#               #  #
#               #  #
####################