####################
#               #  #
#          #  ###  #
#          ###     #
#  ###             #
#   #              #
#   #              #
#   #########   #  #
#               #  #
#               #  #
####################