####################
#                  #
#         #        #
#         #        #
#         #        #
#         #        #
#         #        #
#         #        #
#         #        #
#         #        #
#         #        #
#         #        #
#         #        #
#         #        #
#         #        #
#         #        #
#         #        #
#         #        #
#         #        #
#         #        #
#         #        #
#         #        #
####################