############################################################
#                  #########################################
#                  #########################################
#                  #########################################
#                  #########################################
#################  #########################################
#################  ##############          #################
#################  ############## ######## #################
#################  ############## ######## #################
#################  ############## ######## #################
#################  ############## ######## #################
#################                 ######## #################
########################################## #################
########################################## #################
########################################## #################
########################################## #################
########################################## #################
########################################## #################
##########################                 #################
##########################                 #################
##########################                 #################
##########################                 #################
##########################                 #################
##########################                 #################
##########################                 #################
######       #############                 #################
######       #############                 #################
######       #############                 #################
###########                                #################
############################################################
############################################################
############################################################
############################################################
############################################################
############################################################
