#######################
#                     #
#  *      ####        #
#         ####        #
#         #############
#         #############
#                     #
#   ###               #
#   ###               #
#   ###               #
#                     #
#######################